NO ./tex/hippo_tex_n.xpm
SO ./tex/hippo_tex_s.xpm
WE ./tex/hippo_tex_w.xpm
EA ./tex/hippo_tex_e.xpm

F 194,178,128
C 135,206,235

     11111111111111111      111
   11100000000000000011111111011
  11000000000000000000000000000111
 1100000000000000000N00000000000001111
110000000000000000000000000000000000111111
1000000000000000000000000000000000000000011
1100000000000000000000000000000000000000011
 111000000000000000000000000011111100000011
   111000000000111111111000111    11111111
     10001110001       10001
     11111 11111       11111