NO ./tex/brick_north.xpm
SO ./tex/brick_south.xpm
WE ./tex/brick_west.xpm
EA ./tex/brick_east.xpm

F 192,192,192
C 135,205,235

        1111111111111111111111111
        1000000000110000000000001
        1011000001110000000000001
        1001000000000000000000001
111111111011000001110000000000001
100000000011000001110111111111111
11110111111111011100000010001
11110111111111011101010010001
110000001101010111000N0000001
100000000000000011000000100011
100000000000000011010100100011
1100000111010101111101111000111
11110111 1110101 101111010001
11111111 1111111 111111111111