NO ./tex/texture_from_hell.xpm
SO ./tex/texture_from_hell.xpm
WE ./tex/texture_from_hell.xpm
EA ./tex/texture_from_hell.xpm

F 192,192,192
C 135,205,235

111111111111111111111111
100000000000000000000001
100000000000001000000001
100000000000000000000001
100000111110000101010001
100000100010000000000001
100000100010000100010001
100000100010000000000001
100000110110000101010001
100001000000000000000001
100000000001000000000001
100000000000000000000001
100000000111111100000001
100001000001000100000001
100001000001000110110001
100000000001110100010001
111111111000010101010001
110100001111010101011111
110000001000000001000001
110100001000000S01000001
110111111011111001001001
110000111010000000000001
111100000010000001001001
111111111111111111111111