111111111111111111111111
100000000000000000000001
100000000000001000000001
100000000000000000000001
100000111110000101010001
100000100010000000000001
100000100010000100010001
100000100010000000000001
100000110110000101010001
100001000S00000000000001
100011111111000000000001
10001     11000000000001
100011111111111100000001
100001000001000100000001
100001000001000110110001
100000000001110100010001
111111111000010101010001
110100001111010101011111
110000001000000001000001
110100001000000001000001
110111111011111001001001
110000111010000000000001
111111111010111111001001
11111   11111   11111111